#####                ###########
#   #######################   # #
# ####                    # #   #
# ##################### # ##### #
#                       #   #   #
##################### #### ##### #
#   ##                    #   #  #
# # ## ### ## #########   ##### ##
# #    #   ## #           #     ##
# # ## ########### ##### #########
### ##           ####         ####
### ###########   ## ##### #### ###
###       ##           #         ###
###### ########## ###### # ##### ###
###### ###           #           B#
A       ###########################
