###                 #########
#   ###################     #
# ####                # # # #
# ################### # # # #
#                     # # # #
##################### # # # #
#   ##                # # # #
# # ## ### ## ######### # #   #
# #    #   ##        #   # # #
# # ## ########### ##### # # #
### ##             ####  # # #
### ############## ## #  # # #
###             ##    #    # #
###### ######## ####### ###  #
###### ####               #   #
A      ####################B###
