###                  ###########
#   #######################   # #
# ####                      #   #
# ################### ##### # ### 
#                       #   #    #
##################### #### ##### #
#   ##                # #     #  #
# # ## ### ## ######### ####### ##
# #    #   ## #                 ##
# # ## ################### ##### #
### ##             ####       ####
### ############## ## ##### ######
###           ##       #       # #
###### ######## ####### ##### #####
###### ####          ###         B#
A        ##########################
