####              ###########
#  #####################   # #
# ####                # #   # #
# ##################### ##### #
#                         #   #
####################### # # # #
#   ##              # # # # # #
# # ## ### ## ##### ### # # # #
# #    #   ##B#     #     #   #
# # ## ############ # ### ### #
### ##           ####  # #   #
### ############  ## # # ### #
###           ##      #   # # #
###### ####### ####### ##### ##
###### ####       ###         #
A       #######################
